8 33 
.................................
.#######..#######..######..#####.
.#######..#######..######..#####.
.................................
.######...@@@@.....@@@@..#####.#.
.#....#....@.@.....@.@...#...#.#.
.######....@@@@@@@@@@@...#####.#.
.................................