13 33 
.................................
.#######..#######..######..#####.
.#######..#######..######..#####.
.................................
.######....@@@.....@@@...#####.#.
.#....#....@@@.....@@@...#...#.#.
.######....@@@@@@@@@@@...#####.#.
.................................